Time,SumPopulation,HerbPopulation,CarnPopulation,OmniPopulation,FPS
0,100,50,50,0,11
1,100,50,50,0,11
2,100,50,50,0,1
3,100,50,50,0,41
4,100,50,50,0,13
5,100,50,50,0,12
6,100,50,50,0,9
7,100,50,50,0,20
8,100,50,50,0,6
9,101,50,51,0,16
10,102,51,51,0,8
11,105,53,52,0,10
12,107,54,53,0,9
13,108,55,53,0,7
14,113,56,57,0,9
15,118,59,59,0,6
16,120,61,59,0,8
